_, _, _, 2, _
3, 6, _, 3, _
1, _, _, 2, _
1, 2, 3, 3, 2
_, _, 1, _, _