2, _, _, _, 1, 2, _, _, _
_, 3, 3, 3, 2, 4, _, 6, 3
2, 2, _, 2, _, 5, _, _, 1
_, 1, _, 2, _, _, 4, 3, 2
1, 1, 1, 2, 4, _, 3, 3, _
_, 1, 3, _, 3, 1, 2, _, _
_, 1, _, _, 2, _, 2, 4, _
_, 1, 2, 3, 2, 2, 2, _, 2
_, _, _, 1, _, 2, _, 2, 1