_, 2, _, 2, _, 1, _, 1, 2, 2, 1
2, 3, 1, 3, 3, 3, 1, 1, _, _, 2
_, 1, _, 1, _, _, 1, 1, 2, 4, _
1, 1, _, 1, 2, 2, 2, 1, 1, 3, _
2, 2, 1, _, _, 1, 2, _, 2, 4, _
_, _, 2, _, 1, 2, _, 2, 2, _, _
_, _, 3, _, 1, _, 2, 2, 3, 6, _
3, _, 3, 1, 1, 2, 2, 2, _, _, _
1, 3, _, 3, 1, 1, _, 3, 4, 7, _
_, 3, _, _, 1, 2, 2, 3, _, _, _
_, 2, _, 3, 1, 1, _, 2, 3, _, 3