_, 1, _, 2, 1, 3, _, 3, 1, 1, _, 1, _, _, _
1, 2, 1, 3, _, 4, _, _, 2, 1, 2, 2, 1, _, _
_, 1, _, 3, _, 4, 3, _, 3, 1, 2, _, 1, _, _
1, 1, _, 2, _, 2, 1, 1, 2, _, 3, 3, 4, 3, 2
_, 1, 2, 3, 2, 1, _, _, 2, 2, 3, _, _, _, _
_, 1, _, _, 1, _, 1, 1, 2, _, 3, 3, 3, 3, 2
2, 3, 4, 4, 3, 2, 3, _, 3, 3, _, 2, _, _, _
_, _, 4, _, _, 3, _, _, 4, 4, _, 3, 2, 1, 1
3, _, 4, _, _, 4, 2, 3, _, _, 4, _, 3, _, 3
1, 1, 2, 3, _, 3, 2, 3, 5, _, 3, 1, 3, _, _
2, 3, 2, 3, 3, _, 2, _, _, 4, 4, 3, 4, 4, 3
_, _, _, 2, _, 2, 2, 2, 3, _, _, _, _, _, 1
_, 6, 4, 5, 3, 2, _, _, 1, 4, _, 6, 4, 2, 1
_, 6, _, _, _, 2, 1, _, 1, 3, _, _, 4, 2, 1
_, _, _, _, 4, _, 1, _, 1, _, 4, _, _, _, 1